11111111111111111111111111111111111
10100000000000000000000000000000001
1P100101001000001010010000000101011
10100100101010100010010000000101011
10000000000C000000000E0000000000011
11111111111111111111111111111111111