11111111111111111111111111111111111
1010C0100000000000000000000000000N1
1P100100001000001010010000000000001
10100100101000100010010000000101011
10C00000000C000000C00E000000N000011
11111111111111111111111111111111111