11111111111111111
100001010010E0P11
11000101001000001
1000000000C000001
11111111111111111