11111111111111111111111
1CCC1CCCCCCCCCCCCC1CCC1
1C1C1011111C11111C1C1C1
1CCPCCCC1CCCCC1CCCCCCC1
111C1C1C1C111C1C1C1CCC1
1CCC1C1C1C101C1C1N1CCC1
1C1C1C1C1C111C1C1C1C1C1
1CCC1C1C0C0C0C0C1C1CCC1
1CCCCC1CCCCCCCCC1CCCCC1
1011111C1110111C1111101
1CCCCCCC100E001CCCCCCC1
1011111N1111111C1111101
1CCCCC1CCCCCCCCC1CCCCC1
1CCC1C1C0C0C0C0C1C1CCC1
1C1C1C1C1C111C1C1C1C1C1
1CCC1N1C1C101C1C1C1CCC1
111C1C1C1C111C1C1C1CCC1
1CCCCCCC1CCCCC1CCCCCCC1
1C1C1011111C11111C1N1C1
1CCC1CCCCCCCCCCCCC1CCC1
11111111111111111111111