1111111111111111111111111111111111
1010P00100000000010000100001000001
10C0101111110010100001110110000111
10C1110100001001010000001110001001
1000000000001100011101100000011001
10111100010000000100010C0011110001
1010000101111111110001001000100011
1011100100000000010001011000101001
1010000111111111011011010011101001
1010100000000001001010000010001111
1011111100010001001010110010000001
1000000111110101000010000111110101
1000100100010101011111100000000001
111110011001010111000E000001001001
1000000000000100000110001001001001
1111111111111111111111111111111111